1111111111111111111
100000Z1000Z0000001
1111000110001111111
1000000000000000001
1000E0011100011Z001
1000010001000100001
1000010001000110001
1000100Z000Z0010001
100011111101111E011
1111111111111111111




            
