11111111111111111111111111
1P00C0Z1000Z000C0010000001
111100011C0011111110000101
100000000000000000Z000C001
10C0Z0011100011Z0C00000001
1000010001C00100011100C001
10001100010001100000000001
1000100Z000Z001000000Z0001
100C111111C1111E0100111001
10000000000C00Z00010000001
10C0Z0011100011Z0C0010Z001
1000010001C001000000110C01
1000000111000C0001001Z0001
10C0Z0011100011Z0C10100Z01
1000010001C001000010110001
11111111111111111111111111


