1111111111111111
1P0Z000CC0000001
1CCZ000ZZ000ZZ01
10C0Z0Z0Z00ZCZC1
10C0Z0ZZ000ZCZC1
100ZZ0CCCZ000001
1CCZZ00Z0C0CC0C1
10Z000CZZC00CC01
100000Z0000Z00E1
1111111111111111
