1111111111111111
1P00010000100001
1000010000100001
1000010000100001
1000010000100001
1000010000100001
1000010Z0P100001
10Z0010000100001
10000100001Z0P01
1111111111111111
