1111111111111111
1P0Z010CC0100001
1CCZ010ZZ010ZZ01
10C0Z1Z0Z01ZCZC1
10C0ZZZZ001ZCZC1
100ZZZCCCZ100001
1CCZZ10Z0C1CC0C1
10Z001CZZC10CC01
100001Z0001Z0001
1111111111111111
