1111111111111111
1P00010000100001
1000010000100001
1000010000100001
1000010000100001
1000010000100001
100001000P100001
1000010000100001
1000010000100P01
1111111111111111
