1111111111111111
1P00010000100001
1000010000100001
10C0Z1Z000100001
1000010000100001
100Z010000100001
1000010Z0P1CCCC1
10Z0010000100001
100001Z0001Z0P01
1111111111111111
