1111111111111111111111111111111111111111111111111
1ZZZZZZZZ1ZZZZZZZZZZZ1ZZZZZZZZZZZZZZZZZZZZ1ZZZZZ1
1ZZ1111111111ZZ1111ZZ1111ZZ1111ZZ1111ZZ1111111ZZ1
1ZZZZZ1ZZZZZZZZ1ZZZZZZZZ1ZZZZZ1ZZ1ZZZZZ1ZZZZZZZZ1
1111ZZ1ZZ1ZZ1111111ZZ1111111111111111ZZ1ZZ1111ZZ1
1ZZZZZZZZ1ZZZZZ1ZZZZZ1ZZZZZ1ZZZZZ1ZZZZZZZZ1ZZZZZ1
1ZZ1ZZ1111111111111ZZ1ZZ1111ZZ1ZZ1111111111ZZ1111
1ZZ1ZZZZZ1ZZ1ZZZZZZZZZZZ1ZZ1ZZ1ZZZZZZZZZZZ1ZZ1ZZ1
1ZZ1111111ZZ1111ZZ1ZZ1ZZ1ZZ1111111111ZZ1ZZ1ZZ1ZZ1
1ZZ1ZZZZZZZZZZZ1ZZ1ZZ1ZZ1ZZZZZ1ZZ1ZZZZZ1ZZ1ZZZZZ1
1ZZ1111111ZZ1111111ZZ1ZZ1ZZ1111ZZ1111111ZZ1CZ1ZZ1
1ZZZZZZZZZZZZZZZZZ1ZZ1ZZZZZZZZZZZ1ZZ1ZZZZZ1ZZ1ZZ1
1ZZ1111111ZZ1111111111111111ZZ1111ZZ1111ZZ1ZZ1111
1ZZ1ZZZZZZZZ1ZZ1ZZZZZ1ZZZZZ1ZZZZZ1ZZZZZZZZ1ZZZZZ1
1111111ZZ1111ZZ1111ZZ1ZZ1111111ZZ1ZZ1111ZZ1ZZ1ZZ1
1ZZZZZZZZZZZ1ZZ1ZZZZZ1ZZZZZZZZZZZ1ZZ1ZZZZZ1ZZ1ZZ1
1111111ZZ1111ZZ1ZZ1ZZ1111ZZ1ZZ1111ZZ1ZZ1111111ZZ1
1ZZZZZZZZ1ZZ1ZZZZZ1ZZZZZ1ZZ1ZZ1ZZ1ZZ1ZZ1ZZZZZ1ZZ1
1111111111ZZ1111111ZZ1ZZ1ZZ1111ZZ1111ZZ1111ZZ1ZZ1
1ZZZZZ1ZZZZZZZZZZZZZZ1ZZZZZ1ZZZZZ1ZZ1ZZZZZZZZZZZ1
1111ZZ1ZZ1ZZ1ZZ1111ZZ1111ZZ1ZZ1ZZ1ZZ1111111111ZZ1
1ZZZZZ1ZZ1ZZ1ZZ1ZZ1ZZZZZ1ZZZZZ1ZZZZZZZZ1ZZ1ZZZZZ1
1ZZ1111111ZZ1ZZ1ZZ1111111111ZZ1111111111ZZ1ZZ1111
1ZZZZZZZZ1ZC1ZZ1ZZZZZ1ZZ1ZZ1ZZ1ZZZZZZZZ1ZZ1ZZ1ZZ1
1ZZ1111111ZZ1111ZZ1111ZZ1ZZ1111ZZ1111111ZZ1ZZ1ZZ1
1ZZZZZZZZZZZZZZZZZ1ZZ1ZZZZZZZZZZZZZZZZZZZZZZZZZZ1
1ZC1ZZ1ZZ1111111111ZZ1ZZ1111ZZ1ZZ1111111111111111
1ZZ1ZZ1ZZZZZZZZZZZZZZ1ZZ1ZZZZZ1ZZ1ZZZZZZZZ1ZZZZZ1
1111111ZZ1111111111ZZ1111111ZZ1ZZ1ZZ1ZZ1111111ZZ1
1ZZZZZZZZ1ZZ1ZZZZZZZZ1ZZZZZZZZ1ZZZZZ1ZZZZZZZZ1ZZ1
1ZZ1111ZZ1ZZ1111ZZ1ZZ1ZZ1111ZZ1111111111111111ZZ1
1ZZ1ZZZZZZZZ1ZZZZZ1ZZZZZ1ZZZZZZZZZZZZZZZZZZZZZZE1
1111111111111111111111111111111111111111111111111