1111111111111111111111111111111111111111111111111
1P00000001000000000001000000000000000000001000001
1001111111111001111001111001111001111001000C11001
1000001000000001000000001000001001000001000000001
1111001001001111111001111111111111111001001111001
1000000001000001000001000001000001000000001000001
1001001111111111111001001111001001111111111001111
1001000001001000000000001001001000000000001001001
1001111111001111001001001001111111111001001001001
1001000000000001001001001000001001000001001000001
1001111111001111111001001001111001111111001C01001
1000000000000000001001000Z00000001001000001001001
1001111111001111111111111111001111001111001001111
10010000000010010000010000010Z0001000000001000001
1111111001111001111001001111111001001111001001001
1000000000001001000001Z00000000001001000001001001
1111111001111001001001111001001111001001111111001
1000000001001000001000001001001001001001000001001
1111111111001111111001001001111001111C01111001001
10000010000000000000010000010Z0001001000000000001
1111001001001001111001111001001001001111111111001
10000010010010010010000C1000001000000001001000001
1001111111001001001111111111001111111111001001111
10000000010C1001000001001001001000P00001001001001
1001111111001111001111001001111001111111001001001
1000000000000000001001000000000000000000000000001
10C1001001111111111001001111001001111111111111111
1001001000000000ZC0001001000001001000000001000001
1111111001111111111001111111001001001001111111001
1000000001001000000001000000001000001000000001001
1001111001001111001001001111001111111111111111001
10010000000010000010000010000000000000000000000E1
1111111111111111111111111111111111111111111111111
