1111111111111111
1PPPP1PPPP1PPPP1
1PPPP1PPPP1PPPP1
1PPPP1PPPP1PPPP1
1PPPP1PPPP1PPPP1
1PPPP1PPPP1PPPP1
1PPPP1PPPP1PPPP1
1PPPP1PPPP1PPPP1
1PPPP1PPPP1PPPP1
1111111111111111
