1111111111111111
1ZZZZ1ZZZZ1ZZZZ1
1ZZZZ1ZZZZ1ZZZZ1
1ZZZZ1ZZZZ1ZZZZ1
1ZZZZ1ZZZZ1ZZZZ1
1ZZZZ1ZZZZ1ZZZZ1
1ZZZZ1ZZZZ1ZZZZ1
1ZZZZ1ZZZZ1ZZZZ1
1ZZZZ1ZZZZ1ZZZZ1
1111111111111111
