11111111111111111111111111
1P0000000000100010000ZC001
100Z010C001000C100010C0011
10C0Z1Z000010Z0100C10ZC001
100C0100C010000100000ZC001
100Z01000000100000000ZC001
10Z0010Z00001000100ZC00101
10Z00100001000ZC000Z0000C1
100Z01Z00C0100010E000ZC001
11111111111111111111111111
