11111111111111111111111111
1P0001000P00100P10000ZC0P1
100Z010CP01000EEEEEEZC0P11
10C0Z1Z00P010Z0100C10ZC0P1
100C0100C010000100000ZC0P1
100Z0100P000100010000ZC0P1
10Z0010Z0P001000100ZC0P101
10Z00100001000ZC0P0Z00P0C1
100Z01Z00C010P010000ZC00P1
11111111111111111111111111
