111111111111111111111
1P00C0Z1000Z000C001
111100011C00111111
10000000000000001
10C0Z0011100011Z0C1
1000010001C0010001
1000010001000110001
1000100Z000Z0010001
100C111111C1111E0111
11111111111111111111111
